NO ./texture/eagle.xpm
SO ./texture/greystone.xpm
WE ./texture/purplestone.xpm
EA ./texture/red.xpm

F 220,100,0
C 225,30,0

111111111111111111111111111111
11111111100000000000000001111001
100000000000000000111000100001
110000100000000000000000001111
100001111111000000000000111111
1111111000000000W0000000000001
111100000000001100000000000011
1                            1
110000000000011110000000000011
100000000000111000000000000011
11000000000011100000000000111100
110000000001111000000000000111
111111111111111111111111111111111
